ball=664 536
hole=336 272
tilemap=1 1 1 1 1 1 1 1 1 1 1 1
		1 0 1 0 0 0 0 0 0 0 1 1
		1 0 0 0 1 1 1 1 0 0 1 1
		1 0 1 0 0 0 0 1 0 0 1 1
		1 0 1 0 1 0 1 1 0 0 0 1
		1 0 1 0 1 0 0 1 0 0 0 1
		1 0 1 0 1 1 1 1 0 1 0 1
		1 0 1 0 0 0 0 0 0 1 0 1
		1 0 0 0 0 0 0 0 0 1 0 1
		1 1 1 1 1 1 1 1 1 1 1 1