ball=664 536
hole=256 192
tilemap=1 1 1 1 1 1 1 1 1 1 1 1
		1 0 0 0 0 0 0 0 0 0 0 1
		1 0 1 1 1 0 1 1 1 1 0 1
		1 0 0 1 0 0 0 0 1 0 0 1
		1 0 0 0 0 1 0 0 1 0 0 1
		1 0 1 1 1 1 0 0 1 1 0 1
		1 0 0 0 0 1 0 0 1 0 0 1
		1 0 0 0 0 1 0 0 1 0 0 1
		1 0 0 0 0 0 0 0 0 0 0 1
		1 1 1 1 1 1 1 1 1 1 1 1