ball=72 512
hole=656 80
tilemap=1 1 1 1 1 1 1 1 1 1 1 1
		1 0 0 0 1 0 0 0 1 0 0 1
		1 0 1 0 0 0 1 0 0 0 1 1
		1 0 0 0 1 0 0 0 1 0 0 1
		1 0 1 0 0 0 1 0 0 0 1 1
		1 0 0 0 1 0 0 0 1 0 0 1
		1 0 1 0 0 0 1 0 0 0 1 1
		1 0 0 0 1 0 0 0 1 0 0 1
		1 0 1 0 0 0 1 0 0 0 1 1
		1 1 1 1 1 1 1 1 1 1 1 1